10
10
WRGGGGRRRR
W1WGGRG2RR
RWGGGRGGRR
RSGGGGGRRR
RRRRRGGGRR
RR3RRGGGHR
RRGGWFGGRR
RRGGHWGGMR
RRGGHWGGMR
4RRRRRRRRR
