40
20
MRGGGGRRRMMMMMMMMRFFWWWRRRMMMMMMMMMMMM
W2WGGRGRRRMMMMMMRRFFRWWF4FFRMMMMMMMMMM
WWWGGRGGRRWMMMMMRFFFWWWFFFFRRMMMMMMMMM
WSWGGGGRRRWRRRRRRFFFFFGGFFFRRRMMMMMMMM
SSSSRGGGRRWRGGGGRRRWWWHHHHRHHRMMMMMMMM
RSSHHHHWWWWWGGGGRRRWWWHHHHHRRRMMMMMMMM
RRGGWFGGRRWWGGGGRRRRWWWGWSSSSRRMMMMMMM
RRGGHWGGMRWWWGGGRRRRRRWWWSSSRSMMMMMMMM
RRGGHWGGMRWWWWGGRRRRWWWWWGRRRRMMMMMMMM
RRRRRRRRRRWRGGGGRRRWRRWWWGRRRRMMMMMMMM
WRGGGGRRRRWRG3GGHHRRRRGGGGRRRRMMMMMMMM
WRWGGRGHHHRRGHHHRRRRWRGGGGRRRRMMMMMMMM
RWGGGRHHHRWRGHHHFFFWWRGGFFFFFFMMMMMMMM
RSGGFFFFFFWRGGGGFFFWWRHHFFFWWWMMMMMMMM
RRRRRFFFFFFFFFFFFFFWWRHHWWSSSSMMMMMMMM
RFFFFFFFFWWWFFFFRRRWWRGGGGWWWSMMMMMMMM
RFFFFFFFWWWFFFFFFRRWWRGGGGWWWWMMMMMMMM
RRGGHWGGMRWRGGGGRRRGWWGGGGRRRRMMMMMMMM
RRGGHWGGMRWRGGGGRRRRWWGGGGRR1RMMMMMMMM
RRRRRRRRRRWRGGGGRRRRWWGGGGRRRMMMMMMMMM