40
20
MRGGGGRRRMMMMMMMMRFFWWWRRRMMMMMMMMMM
W2WGGRGRRRMMMMMMRRFFRWWF4FFRMMMRMMMR
WWWGGRGGRRWMMMMMRFFFWWWFFFFRRMGRRRRM
WSWGGGGRRRWRRRRRRFFFFFGGFFFRRRRMMMGR
SSSSRGGGRRWRGGGGRRRWWWHHHHRHHRRRRGGR
RSSHHHHWWWWWGGGGRRRWWWHHHHHRRRRRGGRR
RRGGWFGGRRWWGGGGRRRRWWWGWSSSSRWRGGGR
RRGGHWGGMRWWWGGGRRRRRRWWWSSSRRWRGGRR
9RGGHWGGMRWWWWGGRRRRWWWWWGRR5RRWRGRR
RRRRRRRRRRWRGGGGRRRWRRWWWGRRRRWRGGGR
WRGGGGRRRRWRGGGGHHRRRRGGGGRRRRWRRRRG
WRWGGRGHHHRRGHHHRRRRWRGGGGRRRRW6RGGR
RWGGGRHHHRWRGHHHFFFWWRGGFFFFFFWRRGGR
RSGGFFFFFFWRGGGGFFFWWRHHFFFWWWWRRRGR
RRRRRFFFFFFFFFFFFFFWWRHHWWSSSSRWRGGR
RFFFFFFFFWWWFFFFRRRWWRGGGGWWWSRW1GGR
RFFFFFFFWWWFFFFFFRRWWRGGGGWWWWRWWRRR
RRG3HWGGMRWRGGGGRRRGWWGGGGRRRRWRGRRR
RRGGHWGGMRWRGGGGRRRRWWGGGGRR8RWRRGGR
RRRRRRRRRRWRGGGGRRRRWWGGGGRR7RWRGMMR
